year,CS-MAJO,CS-SPEC,CS-MANA,IT-MAJO,IT-SPEC,total
2007,3,0,26,29,0,58
2009,2,0,5,51,0,58
2010,22,0,13,61,0,96
2011,2,21,16,72,0,111
2012,4,43,15,54,0,116
2013,2,31,8,81,0,122
2014,13,17,4,65,0,99
2015,8,48,9,51,0,116
2016,2,79,10,11,39,141
2017,6,75,19,9,45,154
2018,35,47,12,29,24,147
2019,60,40,32,36,20,188
2020,65,51,32,41,14,203
2021,77,53,43,25,20,218
2022,111,69,32,36,19,267