year,CS-MAJO,CS-SPEC,CS-MANA,CS-MASP,IT-MAJO,IT-SPEC,total
2007,3,0,26,0,29,0,58
2008,0,0,0,0,0,0,0
2009,2,0,5,0,51,0,58
2010,22,0,13,0,61,0,96
2011,2,21,16,0,72,0,111
2012,4,43,15,0,54,0,116
2013,2,31,8,0,81,0,122
2014,13,17,4,0,65,0,99
2015,8,48,9,0,51,0,116
2016,30,162,0,30,127,94,443
2017,33,201,21,21,89,91,456
2018,72,196,29,12,74,101,484
2019,130,173,62,5,111,93,574
2020,170,167,79,3,125,76,620
2021,207,174,99,4,131,66,681
2022,264,187,96,3,132,61,743